type octile
height 5
width 5
map
.....
...x.
..x..
.x...
.....
