type octile
height 4
width 5
map
.....
.....
@@@..
@@@..
